2 4 11364 11339 1577 966 
2 6 7271 7190 7143 1702 7091 2989 
2 4 7299 2925 1674 1175 
2 2 1175 7190 
2 7 7271 7330 7391 3156 1821 2168 7607 
2 7 2989 7141 1752 4408 2929 1767 4319 
2 4 6170 4969 2458 7299 
2 3 6170 7151 7103 
2 5 2874 7771 670 7781 3123 
2 6 2874 7718 7680 7626 7603 3232 
2 4 3232 7498 5632 5954 
2 5 7498 7473 7429 76 4319 
2 4 5954 7352 1071 6888 
2 3 6888 7247 7192 
1 8 1752 2591 7144 709 7184 7165 5115 7192 
2 3 7680 7668 7697 
2 7 3850 1215 2937 8059 8053 8074 2324 
1 2 7856 7899 
2 5 8246 8190 110 8083 2937 
2 7 8084 8133 8197 2537 4698 8228 8246 
2 5 8084 8068 5251 5881 7997 
2 3 7997 1861 7928 
2 4 3123 7850 5553 7928 
2 6 7997 6315 7927 7905 7878 7846 
2 6 7697 941 7753 7794 896 7846 
2 6 7846 4205 7780 7779 7815 2820 
2 6 2820 561 7852 7826 3141 7856 
2 5 7607 3085 7752 2544 7826 
