2 4 11364 11339 1577 966 
2 6 7271 7190 7143 1702 7091 2989 
2 4 7299 2925 1674 1175 
2 2 1175 7190 
2 7 7271 7330 7391 3156 1821 2168 7607 
2 7 2989 7141 1752 4408 2929 1767 4319 
2 4 6170 4969 2458 7299 
2 3 6170 7151 7103 
2 5 2874 7771 670 7781 3123 
2 6 2874 7718 7680 7626 7603 3232 
2 4 3232 7498 5632 5954 
2 5 7498 7473 7429 76 4319 
2 4 5954 7352 1071 6888 
2 3 6888 7247 7192 
1 8 1752 2591 7144 709 7184 7165 5115 7192 
2 3 7680 7668 7697 
